#################
#     #     #   #
# ### # # # # # #
# # ### # # # # #
#     # # ### # #
##### # # #   # #
#   # # # # ### #
# #   # # # # # #
  ### # # # # #  
# # # # # # # ###
#   # # # # # # #
# # #   # # # # #
# # ## ## #     #
# #  # #  ### # #
# ## # ## # ### #
#  # #          #
#################